@Quickstep



@SONG - ARTIST

In the Next Room - Neon Trees

Fly or Die - Rock Mafia

Kryptonite - The New Rock Superheroes

Hey Pachuco! - Royal Crown Revue

I Want You to Want Me - Cheap Trick

Puttin' On the Ritz - Fred Astaire

Walking on Sunghine - Katrina & The Waves

It Don't Mean a Thing - Duke Ellington & Ivie Anderson

Diamond's Are a Girl's Best Friend - Marilyn Monroe

Signed, Sealed, Delivered I'm Yours - Stevie Wonder

Life is a Highway - Rascal Flatts

Krytonite - 3 Doors Down

You're the One That I Want - John Travolta & Olivia Newton

Neutron Dance - The Pointer Sisters

Close to Me - The Cure

We Go Together - John Travolta & Olivia Newton

Top Hat, Whit Tie and Tails - Fred Astaire

Why Can't I Be Like You - The Cure

9 to 5 - Dolly Parton

Sing, Sing, Sing - The Andrew Sisters

Do Your Thing - Basement Jaxx

Black Horse & the Cherry Tree - KT Tunstall

Two Hearts - Phil Collins

Don't Get Me Wrong - Pretenders

The Lady is a Tramp - Tony Bennet & Lady Gaga

Viva las Vegas - Elvis Presley

Part-Time Lover - Stevie Wonder

Suddenly I See - KT Tunstall

Good Morning - The London Theatre Orchestra and Cast

Swing With Me - Jessica Simpson

The Dirty Boogie - The Brian Setzer Orchestra

Theres a Good Reason These Tables Are Numbered Honey, You Just Haven't Thought of it Yet - Panic! at the Disco

Valerie - Mark Ronson featuring Amy Winehouse

369 - Cupid featuring B.o.B

I Feel it All - Feist

Smile (Mike Ronson Remix) - Lily Allen

Mess Around - Ray Charles

Next To Me - Cover Mogul

Mountain Sound - Of Monster and Men

Funhouse - P!nk

Burn It Down - AWOLNATION

Falling Down - Atreyu

Sins of My Youth - Neon Trees

Little Talkes - Of Monsters and Men

Electric Worry - Clutch

Are You Gonna Be My Girl - JET

Mental Strain At Dawn - Jack Purvis

The Skeleton In the Closet - Putney Dandridge

Happy Feet - John Altman

Everything's Magic - Angels & Airwaves

Unholy Confessions - Avenged Sevenfold

The Lovecats - The Cure

The Bomb - Bitter:Sweet

It Happens - Sugarland

Holiday - Vampire Weekend

It Gets Better - Fun.

Benson Hedges - Fun.

New Days - Delta Rae

San Francisco - The Mowgli's

Never Gonna Let You Go - Esthero

Gracefully - Esthero

Anna Sun - WALK THE MOON

Hipbrass - Frohlocker

Charleston Butterfly - Parov Stelar

Cinnamon Girl - [dukelbunt]

Sax and Soda - Dani Cargo

Gypsie Doodle - Analogik

Let's Go Home - Coltrain

Second Chance - Cory Morrow

A Boy Named Sue - Johnny Cash

I Walk the Line - Johnny Cash

How I Got to Be This Way - Justin Moore

Little Bit More - Rosie Flores

Mud On the Tires - Brad Paisley

Mama's Broken Heart - Miranda Lambert

Pavement Ends - Little Big Town

On Fire Tonight - Little Big Town

Little Talks - Of Monsters and Men

Bless You - Delta Rae

Wake Me Up - Avicii
