@Samba
@SONG - ARTIST

Say This Sooner - The Almost

Baby Boy - Beyoncé

Run the Show - Kat DeLuna

That's Not My Name - The Ting Tings

I Want You To... (Madhatterz Version) - Jem

Bananza (Belly Dancer) - Various Artists

I Like to Move It - The Hit Crew

Party in the U.S.A - Miley Cyrus

Get Busy - Sean Paul

Naughty Girl - Beyoncé

Spice Up Your Life - Spice Girls

Get Down On It - Kool & The Gang

Two Princes - Spin Doctors

A Little Respect - Erasure

Jaleo (Spanglish) - Ricky Martin

Bad Girls - Donna Summer

Livin' La Vida Loca - Ricky Martin

Baila Baila - Angela Via

Jump in the Line - Harry Belafonte

Shake Your Bon-Bon - Ricky Martin

Sweet Home Alabama - Lynyrd Skynyrd

Shake Senora - Pitbull featuring T-Pain & Sean Paul)

Bailamos - Enrique Iglesias

Cha Cha - Chelo

I Like to Move It - Reel 2 Reel featuring The Mad Stuntman

Pon De Replay - Rihanna

My Girls - Christina Aguilera

Cupid Shuffle - Cupid

Fever - La Lupe

Rabiosa - Shakira featuring Pitbull

Run the World (Girls) - Beyoncé

Boom - Alex Wilson

Hotel California - los Fernandos

My Number One - Helena Paparizou

Katse Kala - Helena Paparizou

Heroes - Helena Paparizou

The Game of Love (Greenglish) - Helena Paparizou

Mesa Sou - Stavento & Helena Paparizou

Heart of Mine - Helena Paparizou

Carpe Diem (Seize the Day) - Helena Paparizou

Gigolo - Helena Paparizou

Gigolo (Greek) - Helena Paparizou

Ta Lefta (Original) - Despina Vandi

Hey, Soul Sister - Train

Shark In the Water - V.V. Brown

Hey Baby - No Doubt & Bounty Killer

When I See You - Macy Gray

Pharma Sutra - ill.gates & Filastine





@ARTIST - SONG
 Train - "Hey, Soul Sister"
V.V. Brown - "Shark In The Water"
No Doubt - "Hey Baby"

 Karmin – Too Many Fish
Destiny’s Child – Sexy Daddy
Billy Joel – River Of Dreams
Jade – Don’t Walk Away
Shakira – Hips Don’t Lie 



 Yanni – Ritual De Amor
Michael Franti – Say Hey (I Love You)
Jesse Cook - Cecelia 

 Kiss Kiss - Tarkan Şımarık
Coco Jambo - Mr. President 
 
