@Tango
@SONG - ARTIST

Rumour Has It - ADELE

Hey Sexy Lady - Shaggy

Toxic - Britney Spears

Dance With Me - Debelah Morgan

"The Take Over, the Breaks Over" - Fall Out Boy

Tainted Love - Soft Cell

Hey Ya! - Outkast

Adams Family Theme - The Hit Crew

Main Title Theme - Danny Elfman

The Phantom of the Opera - The Phantom of the Opera

Conquest - The White Stripes

Disturbia - Rihanna

Shut Up - The Black Eyed Peas

I Can't Tell a Waltz from a Tango - Alma Cogan

Hernando's Hideaway - Alfred Hause's Tango Orchestra

What You Waiting For? - Gwen Stefani

Jessie's Girl - Rick Springfield

Caramel - City High

Prelude 12/21 - AFI

Say it Right - Nelly Furtado

Objection (Tango) - Shakira

Sway - The Pussycat Dolls

Trinity - Paper Tongues

Down to Earth - Jem

It's Amazing - Jem

Helena Beat - Foster the People

I Want You To...(Madhatterz Remix) - Jem

Changing - The Airborne Toxic Event

We Are Young - Fun.

Wake Up - AWOLNATION

La Cumparisita - Alfred Hause's Tango

You Know I'm No Good - Amy Winehouse

Our God's Alive - Andy Cherry

Boondocks - Little Big Town

Somebody's Burning (Put the Fire Out) - Helena Paparizou

Faster - Rachel Yamagata

Salsa - Various Artists from the Album Mumbai Salsa

Some Nights - Fun.

The End - Kid Cudi

Tango - Kenny G

See You When I See You - Jason Aldean

Good Girl - Carrie Underwood

Girl On Fire - Alicia Keys

Swallow Me - Esthero

Kick It In the Sticks - Brantley Gilbert

It's Time - Imagine Dragons

Madness - Muse

Demons - Imagine Dragons

Uprising - Muse

Supermassive Black Hole - Muse

Panic Station - Muse

Slapdash Era - Beats Antique

Dei mir bist du schon (Dub) - Waldeck

Grandstand - Beats Antique

Poisson rouge - Saint Privat

Who By Fire - Suns of Arqa

White Rabbits - Jefferson Airplane

Tornado - Little Big Town

Just Give Me a Reason - Pink

Seven Nation Army - Alice Russell

Addicted to Love - Robert Palmer

400 Lux - Lorde

White Teeth Teens - Lorde

Glory and Gore - Lorde

 The Monster - Eminem feat. Rihanna

Sos - Rihanna

Love Runs Out - OneRepublic

Come With Me Now - KONGOS

Somethin' Bad - Miranda Lambert feat. Carrie Underwood

Na Na - Trey Songz

 5am - Katy B 




