@Viennese Waltz
@SONG - ARTIST
Waltz of the Damned - Yoko Shimomura

When the Stars Go Blue - Bethany Joy Lenz

Won't Back Down - Eminem featuring Pink

Slow Me Down - Emmy Rossum

Breakable - Ingrid Michaelson

Hear You Me - Jimmy Eat World

The Only Exception - Paramore

Dream - Priscilla Ahn

You Guardian Angel - The Red Jumpsuit Apparatus

Swing Life Away - Rise Against

Hero - Skillet

Sidewalks - Story of the Year

Once Upon a December - Sarah Morgann

Daughters - John Mayer

The Black Pearl - Klaus Badelt

Only Hope - Mandy Moore

Hedwig's Theme - Harry Potter Theme

You and Me - Lifehouse

Breakaway - Kelly Clarkson

Breather - Anna Nalick

Crazy - Aerosmith

Love Just Is - Hilary Duff

I'll Never Break Your Heart - Backstreet Boys

Keep Holding On - Avril Lavigne

Iris - The Goo Goo Dolls

Breaking the Girl - Red Hot Chili Peppers

I'm With you - Avril Lavigne

Between - Vienna Teng

Nothing Else Matters - Bif Naked

Thunder - Boys Like Girls

Paris - Yael Naím

World Falls Away - Seether

Working Class Hero - Marilyn Manson

Working Class Hero - Green Day

Crazier - Taylor Swift

Lucky - Bif Naked

Waltz - The Little Ones

Waltz - Jim Dooley

Potter Waltz - Harry Potter Goblet of Fire Soundtrack

Waltz for Eva and Che - Madonna

Waltz ( Better Than Fine) - Fiona Apple

Marguerite Waltz - I Salonisti

Kentish Town Waltz - Imelda May

(How Much Is) That Doggie in the Window - Patti Page

A Thousand Years - Christina Perri

Kathleen - David Gray featuring Jolie Holland

Waltz From Masquerade - Taraf de Haídouks

Caribbean Blue - Enya

Fascination - Nat "King" Cole

Take It to the Limit - Eagles

Missing You - Jem

All the Right Moves - One Republic

A Moment Like This - Kelly Clarkson

You and Me - Lifehouse

Show Me the Way - Styx

What the World Needs Now Is Love - Jackie DeShannon

Colorblind - Overtone

Hero - Chad Kroeger

3 Libras - A Perfect Circle

A Wolf At the Door - Radiohead

All in All (This One Last Wild Waltz) - Dexy's Midnight Runners

The Carny - Nick Cave & The Bad Seeds

Manic Depression - Jimi Hendrix

Waltzinblack - The Stranglers

The Blarney Stone - Ween

Obscured - Smashing Pumpkins

The Millionaire Waltz - Queen

Dear Doctor - The Rolling Stones

What's New Pussycat - Tom Jones

Little Boxes - Engelbert Humperdinck

Why Ya Wanna - Jana Kramer

A Thousand Years pt. 2 - Christina Perri

Skin - Rascal Flatts

The Bad Ones - Blonds

At Last - Etta James




@ARTIST - SONG
 The Tenors - World Stand Still
Incubus - Adolescents 



? - A Cary Grant Romance
? - After the Ball
? - I Will Always Return
? - Once Upon a December
Aly and AJ - No One
Amanda Stott - Homeless Heart
Apocolyptica – Not Strong Enough
Blessed Union of Souls - Light in Your Eyes
Brad Paisley - I'm Still a Guy
Bryan Adams – Have You Ever Really Loved a Woman
Captain & Tennille – Wedding Song
Celine Dion - Seduces Me
Celtic Thunder – Song for the Mira
Chely Wright – What If We Fly
Child’s Play – April Waltz
Daughtry - Life After You
Drip Drop – Safura
E.S. Posthumus - Nara (Theme Song to Cold Case)
Ed Sheeran – Give Me Love
Eli Young Band - Crazy Girl
Emilie Autumn - Marry Me
Erin McCarley - Lovesick Mistake
Faith Hill – Cry
Enya - Flora's Secret
Gigi - Introduction to Maxim's - (soundtrack)
Goo Goo Dolls – Iris
Gotan Project - La del Ruso
Jim Croce – Time in a Bottle
John Denver – Annie’s Song
Klaus Hallen Tanz Orchester - Carribean Blue
Kutless - More Than It Seems
Marilyn Manson - I Put a Spell on You
Molnar Marta - Jo Lenne Elhinni
Peter Gabriel - Down to Earth
Phil Collins - Look Through My Eyes
Philip Hochstrate - Banks of the Seine
Queen – I’m In Love With My Car
R.E.M.- Try Not to Breathe
Safura - Drip Drop
Sarah McLachlan - Ice Cream
Seal - Kiss From A Rose
Secondhand Serenade - A Twist In My Story
Secret Garden – Moving
Si*Sé - The Truth
Taylor Swift - Crazier
Taylor Swift - Dear John
The Moody Blues - Nights in White Satin
The Summer Set - About a Girl
The Young Rascals – How Can I Be Sure
Theory of a Deadman – Wait For Me
Within Temptation – All I Need 


Celtic Woman - The Voice

Game of thrones theme 
