@West Coast Swing

@SONG - ARTIST
Replay - Iyaz
Clumsy - Fergie
Breakeven - The Script
Party In the U.S.A. - Miley Cyrus
Gives You Hell - The All-American Rejects
Unwritten - Natasha Bedingfield
All Summer Long - Kid Rock
Run It! - Chris Brown
Your Love Is My Drug - Ke$ha
Cowboy Casanova - Carrie Underwood
Forever - Chris Brown
Dangerous - Kardinal Offishall featuring Akon
Tik Tok - Ke$ha
Right Round - Flo Rida
California Gurls - Katy Perry featuring Snoop Dog
Angel of Harlem - U2
This Will Be (An Everlasting Love) - Natalie Cole
Boy from New York City - The Manhattan Transfer
Vogue - Modonna
Sharp Dressed Man - ZZ Top
Legs - ZZ Top
The Big Bang - Rock Mafia
Circus/Just Dance - Boyce Avenue
Pink Cadillac - Natalie Cole
Smooth Criminal - Michael Jackson
Hey Eugene - Pink Martini
Good Boy - Dia Frampton
Knock On Wood - Eddie Floyd
All Alone - Fun.
Respect Yourself - Huey Lewis
Because of You - 98^degrees
Mrs. Orleans - Trombone Shortly
The Craziest Thing - Trombone Shortly
Lady (You Bring Me Up) - The Commodores
When Love Comes to Town - U2 & B.B. King
Lovin', Touchin', Squeezin' - Journey
Crazy - Gnarls Barkley
Make the World Move - Christina Aguilera
Bleeding Out - Imagine Dragons
Marry You - Bruno Mars
I Cant Lie - Maroon 5
Respect Yourself - Huey Lewis and the News
Because of You - 98Â°
Mrs Orleans - Trombone Shorty
The Craziest Thing - Trombone Shorty
Lady (You Bring me Up) - Commodores
When Love Comes To Town - Herbie Hancock f Johnny Lang
Lovin, Touchin, Squeezin - Journey 
Here I Am (Come and Take Me) - Seal
G Walkin' - Kenny G
Out Of Time - Danny Wilde
Crazy - Gnarles Barkley
